**********
*P       *
*        *
*        *
*        *
*M       *
*        *
*        *
*  G     *
**********